1.462247062653296847e-01 1.477323807463185867e-01 1.540562770112472446e-01 1.645837225250408320e-01 1.821852355493259468e-01 2.094093106391686221e-01 2.567987605694959652e-01 3.493004364475430501e-01 5.801323214309190845e-01 5.796449366918922097e-01 5.635966462090011841e-01 4.147431706446075284e-01 2.059538394795711325e-01 1.960894339594569658e-01 1.970445556403765675e-01 1.977878305272233461e-01 1.973312998494266834e-01 1.916090765144215502e-01 1.843669626403034723e-01 1.764653400122250804e-01 1.683423525653535424e-01 1.580533825445074869e-01 1.527016781349042618e-01 1.478025379847748844e-01 1.462247062653296847e-01
1.462247062653296847e-01 1.475053224425411924e-01 1.533672110970867031e-01 1.625362443604113361e-01 1.773955367030254915e-01 1.996332841558097204e-01 2.332946874319393182e-01 2.847943079659451815e-01 3.465262538010972504e-01 3.675884192960436891e-01 3.192109376609146287e-01 2.294770848356671999e-01 1.900224301884553824e-01 1.864997812110028019e-01 1.902446844850630425e-01 1.935798046651896476e-01 1.931854853514715087e-01 1.883323901288963542e-01 1.818587176745846690e-01 1.746025241179359755e-01 1.667328525511024007e-01 1.569809967360627223e-01 1.522705880620605357e-01 1.477268761816304121e-01 1.462247062653296847e-01
1.462247062653296847e-01 1.472947820337561498e-01 1.511354359432811600e-01 1.577438189723179007e-01 1.666180004503208245e-01 1.774766326108806469e-01 1.900776434495896061e-01 2.015022475942998270e-01 2.074715153646002341e-01 2.019350426183922353e-01 1.829228788362107783e-01 1.658171051547144836e-01 1.613119683527487469e-01 1.690880268386331098e-01 1.750541656154226966e-01 1.820779435477185293e-01 1.821922627733076616e-01 1.794788347615750845e-01 1.749625097864989376e-01 1.694006457120190157e-01 1.621320303888721115e-01 1.551460471369915661e-01 1.506938334717594918e-01 1.475105519658094222e-01 1.462247062653296847e-01
1.462247062653296847e-01 1.469880115489239636e-01 1.490307812086223149e-01 1.518317963600085418e-01 1.545910773368908975e-01 1.573891652056617907e-01 1.578860926824950106e-01 1.556466049486854575e-01 1.493085670776942153e-01 1.412991631909437662e-01 1.349629343100690326e-01 1.332628330736282396e-01 1.397404178289577970e-01 1.480854394049972156e-01 1.592350158480304589e-01 1.652215900830254214e-01 1.675632370278956618e-01 1.673163502129067226e-01 1.652017424057196093e-01 1.610571703977382585e-01 1.551511810871112895e-01 1.524001589411001778e-01 1.482512183838230468e-01 1.468125633706863220e-01 1.462247062653296847e-01
1.462247062653296847e-01 1.462397099109494225e-01 1.465170371008677475e-01 1.467712008368164123e-01 1.461503967602427456e-01 1.440312777236113229e-01 1.403265136918452061e-01 1.342260438640288933e-01 1.278788804398421353e-01 1.217260287423540671e-01 1.182318887255580930e-01 1.192944475559676309e-01 1.238305621547514113e-01 1.336999163611774233e-01 1.422371367971275169e-01 1.484539450624832724e-01 1.523939110100226146e-01 1.540093338105827936e-01 1.528966855369794375e-01 1.507842615582627166e-01 1.502206413992726863e-01 1.482600841110239265e-01 1.470874832467307380e-01 1.458980231041129283e-01 1.462247062653296847e-01
1.462247062653296847e-01 1.456524804250488581e-01 1.450379551032865977e-01 1.437854747080740125e-01 1.414431571087977346e-01 1.379031848243603697e-01 1.339935100710449578e-01 1.282953239132283707e-01 1.231219373734463163e-01 1.170346155028147567e-01 1.143242438658079729e-01 1.125762612147496039e-01 1.164799095807182022e-01 1.220918305469455151e-01 1.283073437377881820e-01 1.337026361085216497e-01 1.372992591555748099e-01 1.397513699387398778e-01 1.426476718103248387e-01 1.441560720506444015e-01 1.439864075472239435e-01 1.453253219625757764e-01 1.454692693467900255e-01 1.458012066721616762e-01 1.462247062653296847e-01
1.462247062653296847e-01 1.459842857745900224e-01 1.450338345643778226e-01 1.433316506639845112e-01 1.410476176775702917e-01 1.390134444542025505e-01 1.353716816690070657e-01 1.313731763790892404e-01 1.275324067164089470e-01 1.219196771393199902e-01 1.176431935390892525e-01 1.150289506289903230e-01 1.139844908012419000e-01 1.150289506292258151e-01 1.176431935396411721e-01 1.219196771393669804e-01 1.275324067166934694e-01 1.313731763790923213e-01 1.353716816697008163e-01 1.390134444540570557e-01 1.410476176787995584e-01 1.433316506655627209e-01 1.450338345658294947e-01 1.459842857738226363e-01 1.462247062653296847e-01
1.462247062653296847e-01 1.458012066721966760e-01 1.454692693468024045e-01 1.453253219620902481e-01 1.439864075474141247e-01 1.441560720507901461e-01 1.426476718109408459e-01 1.397513699386795372e-01 1.372992591557991859e-01 1.337026361083250292e-01 1.283073437380670978e-01 1.220918305467966619e-01 1.164799095807496493e-01 1.125762612161054915e-01 1.143242438656872501e-01 1.170346155025770024e-01 1.231219373734056405e-01 1.282953239131494061e-01 1.339935100710415439e-01 1.379031848239056224e-01 1.414431571079595162e-01 1.437854747076826589e-01 1.450379551023858737e-01 1.456524804238785165e-01 1.462247062653296847e-01
1.462247062653296847e-01 1.458980231047394827e-01 1.470874832493479778e-01 1.482600841101887057e-01 1.502206413976857891e-01 1.507842615576146239e-01 1.528966855370667011e-01 1.540093338105759935e-01 1.523939110099275795e-01 1.484539450618360956e-01 1.422371367978393919e-01 1.336999163612628549e-01 1.238305621551833990e-01 1.192944475551360184e-01 1.182318887252740286e-01 1.217260287429042659e-01 1.278788804404734358e-01 1.342260438639572284e-01 1.403265136914278177e-01 1.440312777237059971e-01 1.461503967591826214e-01 1.467712008380335498e-01 1.465170371021828344e-01 1.462397099098787512e-01 1.462247062653296847e-01
1.462247062653296847e-01 1.468125633692363707e-01 1.482512183837710884e-01 1.524001589419819169e-01 1.551511810869616870e-01 1.610571703986301284e-01 1.652017424052382444e-01 1.673163502128524605e-01 1.675632370276553818e-01 1.652215900833874929e-01 1.592350158473914701e-01 1.480854394049819778e-01 1.397404178268722152e-01 1.332628330731430721e-01 1.349629343091437450e-01 1.412991631925543667e-01 1.493085670778119822e-01 1.556466049489950987e-01 1.578860926826603506e-01 1.573891652055199042e-01 1.545910773362639268e-01 1.518317963590160580e-01 1.490307812068620286e-01 1.469880115487382788e-01 1.462247062653296847e-01
1.462247062653296847e-01 1.475105519652853137e-01 1.506938334725636541e-01 1.551460471373810601e-01 1.621320303888570957e-01 1.694006457119846543e-01 1.749625097867985035e-01 1.794788347610415391e-01 1.821922627737255218e-01 1.820779435473851848e-01 1.750541656157500459e-01 1.690880268391262431e-01 1.613119683528019821e-01 1.658171051549341690e-01 1.829228788374079318e-01 2.019350426202839166e-01 2.074715153641094045e-01 2.015022475935149826e-01 1.900776434506959434e-01 1.774766326132338756e-01 1.666180004516256141e-01 1.577438189719337081e-01 1.511354359447175666e-01 1.472947820343470382e-01 1.462247062653296847e-01
1.462247062653296847e-01 1.477268761816050158e-01 1.522705880612439389e-01 1.569809967356459723e-01 1.667328525501377001e-01 1.746025241179977872e-01 1.818587176739743794e-01 1.883323901286745594e-01 1.931854853518008286e-01 1.935798046651120985e-01 1.902446844865915143e-01 1.864997812127874854e-01 1.900224301866164645e-01 2.294770848312439049e-01 3.192109376593325609e-01 3.675884192896852753e-01 3.465262538001674941e-01 2.847943079676784062e-01 2.332946874311010721e-01 1.996332841589663065e-01 1.773955367048124510e-01 1.625362443591337469e-01 1.533672110974473313e-01 1.475053224430818988e-01 1.462247062653296847e-01
1.462247062653296847e-01 1.478025379847748844e-01 1.527016781349042618e-01 1.580533825442036466e-01 1.683423525653543751e-01 1.764653400115727411e-01 1.843669626409352169e-01 1.916090765141945096e-01 1.973312998494624049e-01 1.977878305268445935e-01 1.970445556403731258e-01 1.960894339596016001e-01 2.059538394795712435e-01 4.147431706446202959e-01 5.635966462090011841e-01 5.796449366922845625e-01 5.801323214309190845e-01 3.493004364474167622e-01 2.567987605685361774e-01 2.094093106391031467e-01 1.821852355498941312e-01 1.645837225250428859e-01 1.540562770106850277e-01 1.477323807463359062e-01 1.462247062653296847e-01
1.462247062653296847e-01 1.477268761834135691e-01 1.522705880611018026e-01 1.569809967358562763e-01 1.667328525507168757e-01 1.746025241185131527e-01 1.818587176746113976e-01 1.883323901289685742e-01 1.931854853519524018e-01 1.935798046650064330e-01 1.902446844851475860e-01 1.864997812113242392e-01 1.900224301885821698e-01 2.294770848398319241e-01 3.192109376625565931e-01 3.675884192921272109e-01 3.465262537970626444e-01 2.847943079676472644e-01 2.332946874328820364e-01 1.996332841574696704e-01 1.773955367020881579e-01 1.625362443582776539e-01 1.533672110980219550e-01 1.475053224436107258e-01 1.462247062653296847e-01
1.462247062653296847e-01 1.475105519657725350e-01 1.506938334721081019e-01 1.551460471374924155e-01 1.621320303888511838e-01 1.694006457115031505e-01 1.749625097865639967e-01 1.794788347613955615e-01 1.821922627740470702e-01 1.820779435481733599e-01 1.750541656160567172e-01 1.690880268387427721e-01 1.613119683521930803e-01 1.658171051558411935e-01 1.829228788364066494e-01 2.019350426135023691e-01 2.074715153651110477e-01 2.015022475928314738e-01 1.900776434496875278e-01 1.774766326114880777e-01 1.666180004509179857e-01 1.577438189721360184e-01 1.511354359444664619e-01 1.472947820342140612e-01 1.462247062653296847e-01
1.462247062653296847e-01 1.468125633694562504e-01 1.482512183838687880e-01 1.524001589421282998e-01 1.551511810867988173e-01 1.610571703981673319e-01 1.652017424049248562e-01 1.673163502130099456e-01 1.675632370275542127e-01 1.652215900834333451e-01 1.592350158487872702e-01 1.480854394047514400e-01 1.397404178277483477e-01 1.332628330746107870e-01 1.349629343073016075e-01 1.412991631917365487e-01 1.493085670780488761e-01 1.556466049487121306e-01 1.578860926832944822e-01 1.573891652044585032e-01 1.545910773353815493e-01 1.518317963574862817e-01 1.490307812081661243e-01 1.469880115484949734e-01 1.462247062653296847e-01
1.462247062653296847e-01 1.458980231039594400e-01 1.470874832490937645e-01 1.482600841114983525e-01 1.502206413988376454e-01 1.507842615580166357e-01 1.528966855373246614e-01 1.540093338107166310e-01 1.523939110099706007e-01 1.484539450618962420e-01 1.422371367974531453e-01 1.336999163610153307e-01 1.238305621557048014e-01 1.192944475566286716e-01 1.182318887237158861e-01 1.217260287430848437e-01 1.278788804398395262e-01 1.342260438636703468e-01 1.403265136911050481e-01 1.440312777232136687e-01 1.461503967612342303e-01 1.467712008380935573e-01 1.465170371009110739e-01 1.462397099086366614e-01 1.462247062653296847e-01
1.462247062653296847e-01 1.458012066723872457e-01 1.454692693480594268e-01 1.453253219613450109e-01 1.439864075474769634e-01 1.441560720497095105e-01 1.426476718105635089e-01 1.397513699387639141e-01 1.372992591556531083e-01 1.337026361082269688e-01 1.283073437385043314e-01 1.220918305471894866e-01 1.164799095806209328e-01 1.125762612159561527e-01 1.143242438658500920e-01 1.170346155028562374e-01 1.231219373735714384e-01 1.282953239132113565e-01 1.339935100707290716e-01 1.379031848233026603e-01 1.414431571084603378e-01 1.437854747077537965e-01 1.450379551017874913e-01 1.456524804246222271e-01 1.462247062653296847e-01
1.462247062653296847e-01 1.459842857743801348e-01 1.450338345658063466e-01 1.433316506643652344e-01 1.410476176787248404e-01 1.390134444533499547e-01 1.353716816693185943e-01 1.313731763791291529e-01 1.275324067168146225e-01 1.219196771394037704e-01 1.176431935385844202e-01 1.150289506289145364e-01 1.139844908012419000e-01 1.150289506283868474e-01 1.176431935395714501e-01 1.219196771397209889e-01 1.275324067165455877e-01 1.313731763791559370e-01 1.353716816687465241e-01 1.390134444534386893e-01 1.410476176784322688e-01 1.433316506640875676e-01 1.450338345642867288e-01 1.459842857746883327e-01 1.462247062653296847e-01
1.462247062653296847e-01 1.456524804232300352e-01 1.450379551011709567e-01 1.437854747069237937e-01 1.414431571097262419e-01 1.379031848238418401e-01 1.339935100708324334e-01 1.282953239131727485e-01 1.231219373738050293e-01 1.170346155028089835e-01 1.143242438654790971e-01 1.125762612150262992e-01 1.164799095802563494e-01 1.220918305471205140e-01 1.283073437383894788e-01 1.337026361082790937e-01 1.372992591558058473e-01 1.397513699388393260e-01 1.426476718107422270e-01 1.441560720500192350e-01 1.439864075472968297e-01 1.453253219622736014e-01 1.454692693451173080e-01 1.458012066711497634e-01 1.462247062653296847e-01
1.462247062653296847e-01 1.462397099106130527e-01 1.465170371024308027e-01 1.467712008368365906e-01 1.461503967603652032e-01 1.440312777240296549e-01 1.403265136916853617e-01 1.342260438638577247e-01 1.278788804395643575e-01 1.217260287417641362e-01 1.182318887246744943e-01 1.192944475571647567e-01 1.238305621555877561e-01 1.336999163610470553e-01 1.422371367978682022e-01 1.484539450621511214e-01 1.523939110099900296e-01 1.540093338104223664e-01 1.528966855377405232e-01 1.507842615576346912e-01 1.502206413984765176e-01 1.482600841110015555e-01 1.470874832478313021e-01 1.458980231042619202e-01 1.462247062653296847e-01
1.462247062653296847e-01 1.469880115484984429e-01 1.490307812077127092e-01 1.518317963581376773e-01 1.545910773369637559e-01 1.573891652035473709e-01 1.578860926829187272e-01 1.556466049490792258e-01 1.493085670782163532e-01 1.412991631921129143e-01 1.349629343097564771e-01 1.332628330748421019e-01 1.397404178287570409e-01 1.480854394040014288e-01 1.592350158473419541e-01 1.652215900834399231e-01 1.675632370278736794e-01 1.673163502128522939e-01 1.652017424054638139e-01 1.610571703978685154e-01 1.551511810879110664e-01 1.524001589416372759e-01 1.482512183839458375e-01 1.468125633706877375e-01 1.462247062653296847e-01
1.462247062653296847e-01 1.472947820343466496e-01 1.511354359431336947e-01 1.577438189713045169e-01 1.666180004514534463e-01 1.774766326125004345e-01 1.900776434498177292e-01 2.015022475944586999e-01 2.074715153647438137e-01 2.019350426189556458e-01 1.829228788343680301e-01 1.658171051528611051e-01 1.613119683527541870e-01 1.690880268391941887e-01 1.750541656154989134e-01 1.820779435475968211e-01 1.821922627734915701e-01 1.794788347613592017e-01 1.749625097863204970e-01 1.694006457119022480e-01 1.621320303888683922e-01 1.551460471364718707e-01 1.506938334727254969e-01 1.475105519643243046e-01 1.462247062653296847e-01
1.462247062653296847e-01 1.475053224444522193e-01 1.533672110980055514e-01 1.625362443605834206e-01 1.773955367038224928e-01 1.996332841570453986e-01 2.332946874311591923e-01 2.847943079648218578e-01 3.465262537987333635e-01 3.675884192918831284e-01 3.192109376598646353e-01 2.294770848360304094e-01 1.900224301947920635e-01 1.864997812122992094e-01 1.902446844861604425e-01 1.935798046653409987e-01 1.931854853516103698e-01 1.883323901289114810e-01 1.818587176744429212e-01 1.746025241179743615e-01 1.667328525510557435e-01 1.569809967365828896e-01 1.522705880614690088e-01 1.477268761826677490e-01 1.462247062653296847e-01
1.462247062653296847e-01 1.477323807463185867e-01 1.540562770112471891e-01 1.645837225250408320e-01 1.821852355493259468e-01 2.094093106391687331e-01 2.567987605694959652e-01 3.493004364475431611e-01 5.801323214309187515e-01 5.796449366918922097e-01 5.635966462090010731e-01 4.147431706446074173e-01 2.059538394795711880e-01 1.960894339594569658e-01 1.970445556403765119e-01 1.977878305272234016e-01 1.973312998494266834e-01 1.916090765144214392e-01 1.843669626403033890e-01 1.764653400122250804e-01 1.683423525653535424e-01 1.580533825445074869e-01 1.527016781349042618e-01 1.478025379847748844e-01 1.462247062653296847e-01
