1.146742707822968332e-01 1.252239804484214514e-01 1.401669177019481127e-01 1.611693475071965254e-01 1.910372789262901605e-01 2.366099082451101066e-01 3.110682442158464456e-01 4.504197880798487819e-01 4.904924554951984317e-01 4.783355527096423421e-01 4.215907870506332977e-01 1.245967471043606389e-01 1.217095999978951987e-01 1.266963726692245384e-01 1.299575000760853916e-01 1.327215674494693076e-01 1.301065735621739494e-01 1.256074353246116049e-01 1.201696656038713645e-01 1.128762141707676109e-01 1.085762189828879259e-01 1.051649477356153967e-01 1.047803353734791387e-01 1.080134682391500484e-01 1.146742707822968332e-01
1.146742707822968332e-01 1.247191957340056667e-01 1.387462884376035599e-01 1.578052322459040646e-01 1.834965883338770254e-01 2.192957120995791820e-01 2.692954300366743881e-01 3.283723419546868416e-01 3.510328344456349892e-01 3.056464773767990639e-01 2.027967549392422630e-01 1.228722186783382381e-01 1.182967934736297855e-01 1.233830249522420847e-01 1.271461681188680859e-01 1.300483529326545151e-01 1.279009038208392401e-01 1.238542013024006017e-01 1.186439962280479710e-01 1.115363046221699017e-01 1.078505770524571111e-01 1.048339150325340169e-01 1.049180156846990647e-01 1.081488306974528468e-01 1.146742707822968332e-01
1.146742707822968332e-01 1.234779458660523604e-01 1.348885546847915229e-01 1.488564073049246095e-01 1.655174764961901412e-01 1.842369630134343683e-01 2.023385728740813849e-01 2.129158502271953357e-01 2.059574447478246251e-01 1.774184623296553298e-01 1.390028047197826855e-01 1.119630733650850002e-01 1.098489782039450552e-01 1.150223640707697115e-01 1.195486856970828932e-01 1.228941594343520988e-01 1.219254887806063697e-01 1.190068509318742973e-01 1.138564704566980140e-01 1.095844260717288576e-01 1.057711540521804050e-01 1.043542836869216089e-01 1.050912065469744999e-01 1.085407703642539273e-01 1.146742707822968332e-01
1.146742707822968332e-01 1.215410595863330306e-01 1.293541825765546771e-01 1.376768286954478115e-01 1.454617894018370439e-01 1.515505352885561374e-01 1.535237452403938885e-01 1.496748603404539912e-01 1.386822595881031517e-01 1.224707044942446865e-01 1.071028825544048935e-01 9.866376279976075969e-02 9.951007628686259210e-02 1.047883530890447307e-01 1.091742914809938347e-01 1.125946713272968497e-01 1.128222161775535304e-01 1.106122770766422708e-01 1.085946107358919943e-01 1.060804879001246565e-01 1.045909230673325446e-01 1.041412160411499810e-01 1.059393374213836864e-01 1.093681299364353265e-01 1.146742707822968332e-01
1.146742707822968332e-01 1.190574530068273101e-01 1.233697882887766634e-01 1.267562041330273226e-01 1.286909982752901249e-01 1.281546063366119648e-01 1.248040793654683206e-01 1.181826569218976664e-01 1.093069338346365216e-01 9.944382168632719121e-02 9.199204743800322437e-02 8.910412764356095972e-02 9.053534597927995198e-02 9.535388375468549504e-02 9.927019281090782021e-02 1.022083405213952689e-01 1.039000877508520909e-01 1.043880397829167889e-01 1.033956280789734561e-01 1.032590348985597678e-01 1.036226454695082233e-01 1.047787735395353664e-01 1.072997781566845249e-01 1.106953940421988303e-01 1.146742707822968332e-01
1.146742707822968332e-01 1.166925312710294094e-01 1.178431955426781363e-01 1.178715888703672082e-01 1.165089298054795691e-01 1.135636826640307462e-01 1.090768144019485103e-01 1.033882991450732619e-01 9.704295969260413879e-02 9.111884715326463990e-02 8.659871478487940477e-02 8.461220540863582940e-02 8.489140099658244731e-02 8.816571957205281140e-02 9.168437200999809966e-02 9.450605478112343583e-02 9.710632754416587131e-02 9.906774618326395776e-02 1.010126347361761101e-01 1.027270130784474211e-01 1.047625968944500691e-01 1.071195048521389054e-01 1.096860741814723456e-01 1.122603472447751966e-01 1.146742707822968332e-01
1.146742707822968332e-01 1.143243768764502094e-01 1.132242608982705623e-01 1.111771557117842701e-01 1.087392353236420750e-01 1.057236861176719944e-01 1.021957236045846623e-01 9.832141312283050605e-02 9.423198741223581809e-02 9.002238955091419748e-02 8.685873070007892049e-02 8.382374616255748589e-02 8.305511546691851654e-02 8.382374616293031266e-02 8.685873070083857672e-02 9.002238955135220821e-02 9.423198741219662722e-02 9.832141312279958634e-02 1.021957236042205230e-01 1.057236861193029537e-01 1.087392353235144826e-01 1.111771557107809894e-01 1.132242608984486837e-01 1.143243768775222408e-01 1.146742707822968332e-01
1.146742707822968332e-01 1.122603472444737849e-01 1.096860741786821469e-01 1.071195048518011200e-01 1.047625968947715758e-01 1.027270130791955727e-01 1.010126347365045835e-01 9.906774618326612269e-02 9.710632754432013680e-02 9.450605478085889744e-02 9.168437201032078598e-02 8.816571957242660962e-02 8.489140099545332274e-02 8.461220541020054997e-02 8.659871478459066352e-02 9.111884715246790223e-02 9.704295969267863475e-02 1.033882991451472583e-01 1.090768144022007807e-01 1.135636826638986713e-01 1.165089298067921580e-01 1.178715888696684200e-01 1.178431955417719862e-01 1.166925312703206291e-01 1.146742707822968332e-01
1.146742707822968332e-01 1.106953940419027616e-01 1.072997781556019048e-01 1.047787735391458724e-01 1.036226454694894883e-01 1.032590348980705064e-01 1.033956280789888049e-01 1.043880397832113865e-01 1.039000877508658022e-01 1.022083405215656049e-01 9.927019281085688873e-02 9.535388375383620219e-02 9.053534597763854275e-02 8.910412764362163340e-02 9.199204743777324167e-02 9.944382168577202419e-02 1.093069338345676877e-01 1.181826569220033180e-01 1.248040793659726255e-01 1.281546063374217059e-01 1.286909982735393032e-01 1.267562041333261669e-01 1.233697882877596991e-01 1.190574530069510445e-01 1.146742707822968332e-01
1.146742707822968332e-01 1.093681299358986864e-01 1.059393374205237631e-01 1.041412160404162623e-01 1.045909230674584578e-01 1.060804878999675738e-01 1.085946107359072182e-01 1.106122770766773816e-01 1.128222161776403498e-01 1.125946713268864557e-01 1.091742914805631098e-01 1.047883530886070669e-01 9.951007628510377678e-02 9.866376279890312628e-02 1.071028825565078918e-01 1.224707044952099561e-01 1.386822595879210751e-01 1.496748603403990074e-01 1.535237452402916092e-01 1.515505352872954792e-01 1.454617894038793269e-01 1.376768286963627463e-01 1.293541825755814001e-01 1.215410595868545024e-01 1.146742707822968332e-01
1.146742707822968332e-01 1.085407703639307692e-01 1.050912065479999158e-01 1.043542836881568570e-01 1.057711540512246140e-01 1.095844260710241436e-01 1.138564704572622988e-01 1.190068509316775103e-01 1.219254887806345139e-01 1.228941594341292354e-01 1.195486856967123840e-01 1.150223640710485024e-01 1.098489782034877127e-01 1.119630733672536127e-01 1.390028047208513307e-01 1.774184623343436351e-01 2.059574447456722912e-01 2.129158502269651587e-01 2.023385728733013422e-01 1.842369630139508441e-01 1.655174764940502974e-01 1.488564073075296368e-01 1.348885546837320371e-01 1.234779458680012321e-01 1.146742707822968332e-01
1.146742707822968332e-01 1.081488306972430563e-01 1.049180156832427435e-01 1.048339150317573881e-01 1.078505770517191459e-01 1.115363046226877652e-01 1.186439962278535987e-01 1.238542013023192501e-01 1.279009038209086291e-01 1.300483529329155008e-01 1.271461681195137639e-01 1.233830249520247030e-01 1.182967934740140059e-01 1.228722186823276302e-01 2.027967549325049856e-01 3.056464773804088986e-01 3.510328344456913330e-01 3.283723419531417442e-01 2.692954300376614318e-01 2.192957120983460850e-01 1.834965883329688352e-01 1.578052322456707235e-01 1.387462884371028216e-01 1.247191957343435215e-01 1.146742707822968332e-01
1.146742707822968332e-01 1.080134682391312856e-01 1.047803353734079873e-01 1.051649477357040341e-01 1.085762189822010865e-01 1.128762141699662103e-01 1.201696656036216337e-01 1.256074353241522501e-01 1.301065735621658170e-01 1.327215674496325104e-01 1.299575000761595267e-01 1.266963726693585701e-01 1.217095999978951987e-01 1.245967471043723518e-01 4.215907870506331867e-01 4.783355527098435145e-01 4.904924554946199500e-01 4.504197880791902531e-01 3.110682442163471007e-01 2.366099082446372626e-01 1.910372789268780791e-01 1.611693475073338044e-01 1.401669177019481127e-01 1.252239804482800367e-01 1.146742707822968332e-01
1.146742707822968332e-01 1.081488306965102536e-01 1.049180156846520329e-01 1.048339150317704749e-01 1.078505770518570078e-01 1.115363046218634524e-01 1.186439962278204030e-01 1.238542013023024163e-01 1.279009038208634430e-01 1.300483529325753840e-01 1.271461681194086812e-01 1.233830249520566080e-01 1.182967934738143323e-01 1.228722186828212909e-01 2.027967549291813110e-01 3.056464773702665116e-01 3.510328344455881933e-01 3.283723419550437228e-01 2.692954300386850019e-01 2.192957121006870458e-01 1.834965883306178269e-01 1.578052322449874090e-01 1.387462884385405881e-01 1.247191957342767138e-01 1.146742707822968332e-01
1.146742707822968332e-01 1.085407703651650180e-01 1.050912065482772356e-01 1.043542836859917833e-01 1.057711540512555198e-01 1.095844260721825364e-01 1.138564704570050878e-01 1.190068509318059214e-01 1.219254887805429899e-01 1.228941594342874144e-01 1.195486856969513456e-01 1.150223640706219269e-01 1.098489782045467128e-01 1.119630733655527510e-01 1.390028047212343576e-01 1.774184623337276001e-01 2.059574447450406021e-01 2.129158502264945352e-01 2.023385728734866662e-01 1.842369630141058867e-01 1.655174764947373034e-01 1.488564073068602278e-01 1.348885546829913240e-01 1.234779458678143677e-01 1.146742707822968332e-01
1.146742707822968332e-01 1.093681299373613358e-01 1.059393374211217431e-01 1.041412160398563769e-01 1.045909230684741176e-01 1.060804878997372025e-01 1.085946107361027979e-01 1.106122770765806812e-01 1.128222161775990634e-01 1.125946713272556465e-01 1.091742914806237003e-01 1.047883530886162678e-01 9.951007628750759004e-02 9.866376279993205323e-02 1.071028825561388537e-01 1.224707044944296636e-01 1.386822595879715625e-01 1.496748603404615685e-01 1.535237452399345892e-01 1.515505352880005818e-01 1.454617894017177226e-01 1.376768286956983334e-01 1.293541825759657038e-01 1.215410595862517484e-01 1.146742707822968332e-01
1.146742707822968332e-01 1.106953940419114490e-01 1.072997781568510167e-01 1.047787735396745051e-01 1.036226454692536908e-01 1.032590348977712597e-01 1.033956280790141180e-01 1.043880397832286505e-01 1.039000877507170045e-01 1.022083405218835589e-01 9.927019281069343615e-02 9.535388375433961894e-02 9.053534597876217171e-02 8.910412764461150825e-02 9.199204743886707503e-02 9.944382168674227584e-02 1.093069338341068480e-01 1.181826569220009865e-01 1.248040793661926579e-01 1.281546063366498789e-01 1.286909982745467473e-01 1.267562041352746915e-01 1.233697882879344482e-01 1.190574530077744692e-01 1.146742707822968332e-01
1.146742707822968332e-01 1.122603472441233291e-01 1.096860741806961054e-01 1.071195048520805493e-01 1.047625968950452457e-01 1.027270130788006247e-01 1.010126347364796312e-01 9.906774618319406922e-02 9.710632754433874692e-02 9.450605478108377311e-02 9.168437201022114347e-02 8.816571957271397697e-02 8.489140099631958813e-02 8.461220540963075576e-02 8.659871478531383504e-02 9.111884715296419968e-02 9.704295969291232282e-02 1.033882991450944672e-01 1.090768144022535441e-01 1.135636826632210050e-01 1.165089298055613370e-01 1.178715888687682928e-01 1.178431955425135597e-01 1.166925312696423245e-01 1.146742707822968332e-01
1.146742707822968332e-01 1.143243768764522356e-01 1.132242608984374288e-01 1.111771557111719821e-01 1.087392353217450647e-01 1.057236861186668930e-01 1.021957236046987655e-01 9.832141312286260537e-02 9.423198741209554141e-02 9.002238955054238378e-02 8.685873070048884259e-02 8.382374616279791857e-02 8.305511546691851654e-02 8.382374616149362856e-02 8.685873070060293188e-02 9.002238955110390684e-02 9.423198741251091748e-02 9.832141312278026846e-02 1.021957236040813982e-01 1.057236861188108890e-01 1.087392353236572989e-01 1.111771557098579083e-01 1.132242608989988825e-01 1.143243768781464775e-01 1.146742707822968332e-01
1.146742707822968332e-01 1.166925312695107630e-01 1.178431955418725585e-01 1.178715888698382286e-01 1.165089298057607053e-01 1.135636826635958163e-01 1.090768144018608443e-01 1.033882991451332972e-01 9.704295969289099266e-02 9.111884715283577463e-02 8.659871478504468922e-02 8.461220540950506463e-02 8.489140099588807220e-02 8.816571957198075793e-02 9.168437200979788482e-02 9.450605478101835322e-02 9.710632754431376690e-02 9.906774618311202374e-02 1.010126347362159116e-01 1.027270130786527708e-01 1.047625968952666797e-01 1.071195048521331322e-01 1.096860741802290623e-01 1.122603472447654127e-01 1.146742707822968332e-01
1.146742707822968332e-01 1.190574530069415105e-01 1.233697882879007529e-01 1.267562041339690138e-01 1.286909982744949554e-01 1.281546063370097299e-01 1.248040793660891573e-01 1.181826569220338907e-01 1.093069338342101404e-01 9.944382168689845647e-02 9.199204743937568207e-02 8.910412764413730424e-02 9.053534597825600716e-02 9.535388375463123289e-02 9.927019281054980104e-02 1.022083405217650426e-01 1.039000877507867127e-01 1.043880397830288104e-01 1.033956280791576698e-01 1.032590348982615897e-01 1.036226454693292415e-01 1.047787735389978381e-01 1.072997781563016506e-01 1.106953940429563493e-01 1.146742707822968332e-01
1.146742707822968332e-01 1.215410595862881360e-01 1.293541825757510977e-01 1.376768286948792941e-01 1.454617894024206881e-01 1.515505352878906420e-01 1.535237452397603675e-01 1.496748603406383438e-01 1.386822595878484388e-01 1.224707044939727513e-01 1.071028825572729049e-01 9.866376280079787453e-02 9.951007628568363239e-02 1.047883530883529785e-01 1.091742914808544462e-01 1.125946713270746663e-01 1.128222161776425841e-01 1.106122770766894553e-01 1.085946107357615986e-01 1.060804879003872103e-01 1.045909230697061321e-01 1.041412160400692066e-01 1.059393374216243550e-01 1.093681299359207104e-01 1.146742707822968332e-01
1.146742707822968332e-01 1.234779458690009740e-01 1.348885546842003014e-01 1.488564073055401171e-01 1.655174764926606867e-01 1.842369630135253789e-01 2.023385728736906697e-01 2.129158502264508757e-01 2.059574447454707580e-01 1.774184623305969655e-01 1.390028047219435958e-01 1.119630733658697336e-01 1.098489782039477475e-01 1.150223640709539530e-01 1.195486856971784001e-01 1.228941594343669202e-01 1.219254887807707521e-01 1.190068509317378370e-01 1.138564704573446079e-01 1.095844260716042767e-01 1.057711540515120230e-01 1.043542836876864971e-01 1.050912065472770773e-01 1.085407703640567378e-01 1.146742707822968332e-01
1.146742707822968332e-01 1.247191957338178586e-01 1.387462884357128223e-01 1.578052322450501921e-01 1.834965883329072733e-01 2.192957120987063802e-01 2.692954300393569089e-01 3.283723419537583621e-01 3.510328344445154403e-01 3.056464773740884544e-01 2.027967549289298732e-01 1.228722186831831820e-01 1.182967934724233200e-01 1.233830249522128303e-01 1.271461681186524528e-01 1.300483529329095611e-01 1.279009038207931659e-01 1.238542013027646022e-01 1.186439962277337085e-01 1.115363046220907012e-01 1.078505770525183954e-01 1.048339150315399371e-01 1.049180156846551276e-01 1.081488306988795112e-01 1.146742707822968332e-01
1.146742707822968332e-01 1.252239804484214514e-01 1.401669177019481127e-01 1.611693475071965254e-01 1.910372789262902993e-01 2.366099082451101621e-01 3.110682442158464456e-01 4.504197880798486708e-01 4.904924554951987647e-01 4.783355527096423421e-01 4.215907870506334643e-01 1.245967471043605973e-01 1.217095999978951987e-01 1.266963726692245384e-01 1.299575000760853916e-01 1.327215674494692244e-01 1.301065735621738662e-01 1.256074353246115216e-01 1.201696656038713645e-01 1.128762141707676109e-01 1.085762189828879259e-01 1.051649477356153967e-01 1.047803353734791387e-01 1.080134682391500484e-01 1.146742707822968332e-01
