1.767188162532889462e-01 1.695550673570973277e-01 1.667395377486629859e-01 1.664197842320790655e-01 1.700648551641628647e-01 1.796959548635643777e-01 1.996645392609444902e-01 2.417877995064744157e-01 3.641333665349077431e-01 6.743913556341323279e-01 6.628003336073478025e-01 6.186270245930717282e-01 3.225989584882366645e-01 2.619544720035231755e-01 2.531302467766012310e-01 2.520552674645578084e-01 2.525704075854224295e-01 2.455705002999516162e-01 2.365568160046999657e-01 2.266292386932337588e-01 2.164385109169100208e-01 2.063440716956467524e-01 1.965322865188068868e-01 1.846507326065462695e-01 1.767188162532889462e-01
1.767188162532889462e-01 1.698198326877508046e-01 1.669365226643952094e-01 1.657860020658920297e-01 1.679000424963702776e-01 1.745998490291588157e-01 1.881684467141079287e-01 2.139094456531958621e-01 2.633756574891414348e-01 3.333089861411825949e-01 3.549298408551990747e-01 3.114374502173533066e-01 2.589108022818602528e-01 2.404456982687071809e-01 2.429206929266119752e-01 2.462499615303645195e-01 2.462235908116233718e-01 2.405976555714359477e-01 2.327893156173231060e-01 2.238676511738817709e-01 2.144950973252008897e-01 2.050584584812255862e-01 1.957736234736244807e-01 1.842111630855345628e-01 1.767188162532889462e-01
1.767188162532889462e-01 1.706022342312269180e-01 1.671054749755547797e-01 1.638798041455535315e-01 1.639112326309049017e-01 1.652767271066641341e-01 1.675915395376874617e-01 1.728866200832124833e-01 1.789342598191873412e-01 1.848744142872873475e-01 1.892877991340751465e-01 1.905469419481854998e-01 1.966144922593562050e-01 2.080312230231027015e-01 2.197658811222724384e-01 2.281356026764195244e-01 2.295848989877320723e-01 2.272954597096530638e-01 2.225227173381122137e-01 2.162162293173554573e-01 2.090313796686054937e-01 2.013978357538652175e-01 1.935399327902338207e-01 1.829293442670719416e-01 1.767188162532889462e-01
1.767188162532889462e-01 1.718660405755770004e-01 1.670927640213178966e-01 1.644125114592437653e-01 1.601019703888073298e-01 1.575898054411258853e-01 1.544444354383583684e-01 1.504267235475634235e-01 1.458847215425160271e-01 1.436648489116008343e-01 1.445438699841113117e-01 1.526563091348233092e-01 1.644568305703108246e-01 1.815444235971354625e-01 1.942017172343455111e-01 2.030536197165035139e-01 2.079062999621484331e-01 2.093654015779678468e-01 2.082381947456717064e-01 2.052565622652658683e-01 2.009978109128346402e-01 1.958884711344127394e-01 1.892916489084320586e-01 1.809112240939392269e-01 1.767188162532889462e-01
1.767188162532889462e-01 1.735492932606234606e-01 1.687617222352034430e-01 1.643138607201147239e-01 1.604064684796325801e-01 1.555112632833225983e-01 1.495374713236381492e-01 1.429795694308420295e-01 1.384283172181369759e-01 1.334917827897083298e-01 1.331701842671951519e-01 1.383910626078095341e-01 1.464417306061195356e-01 1.575085224633248626e-01 1.700627119082808447e-01 1.800620226755793862e-01 1.861324763383303549e-01 1.905373926360005854e-01 1.926427088033423329e-01 1.928476651418014609e-01 1.915907421852003634e-01 1.889926601977272302e-01 1.839237581446541148e-01 1.792331402045806432e-01 1.767188162532889462e-01
1.767188162532889462e-01 1.749254079789503979e-01 1.723975980476297187e-01 1.690515043639624904e-01 1.649301718080879442e-01 1.598128619314768406e-01 1.536582169799818876e-01 1.464814176744868024e-01 1.415098064979977144e-01 1.371319824518661967e-01 1.325029119251087684e-01 1.309079474172503699e-01 1.365417991188356550e-01 1.445842573846533863e-01 1.530569366816235677e-01 1.602517937715550733e-01 1.671545672872015720e-01 1.734406075148595683e-01 1.778465790835823679e-01 1.805839611982171522e-01 1.811274495070619162e-01 1.798894300986611794e-01 1.780645653115037474e-01 1.777794572983818489e-01 1.767188162532889462e-01
1.767188162532889462e-01 1.763075906038765461e-01 1.750509461500449060e-01 1.728807612053773757e-01 1.696873343088023955e-01 1.670461286413671698e-01 1.640786129236935509e-01 1.595252717959796118e-01 1.526834436640840398e-01 1.449839416510665391e-01 1.385407240519977712e-01 1.355418948500281828e-01 1.343579119573589109e-01 1.355418948493115616e-01 1.385407240519979655e-01 1.449839416513636070e-01 1.526834436641357207e-01 1.595252717959654010e-01 1.640786129235751456e-01 1.670461286408167489e-01 1.696873343083791785e-01 1.728807612056836029e-01 1.750509461516565057e-01 1.763075906039945073e-01 1.767188162532889462e-01
1.767188162532889462e-01 1.777794572969341458e-01 1.780645653113762383e-01 1.798894300982639416e-01 1.811274495065299805e-01 1.805839611982301696e-01 1.778465790837903404e-01 1.734406075147391091e-01 1.671545672872342403e-01 1.602517937716731178e-01 1.530569366815041910e-01 1.445842573855715962e-01 1.365417991193214053e-01 1.309079474151963185e-01 1.325029119240182518e-01 1.371319824511986751e-01 1.415098064979799786e-01 1.464814176743620133e-01 1.536582169798295094e-01 1.598128619324327426e-01 1.649301718082029633e-01 1.690515043660564265e-01 1.723975980477845948e-01 1.749254079771717374e-01 1.767188162532889462e-01
1.767188162532889462e-01 1.792331402071935809e-01 1.839237581452723147e-01 1.889926601971760045e-01 1.915907421855052584e-01 1.928476651424353983e-01 1.926427088037566127e-01 1.905373926359044401e-01 1.861324763385338310e-01 1.800620226758068987e-01 1.700627119078694793e-01 1.575085224624114266e-01 1.464417306057499424e-01 1.383910626086018447e-01 1.331701842653300605e-01 1.334917827904882059e-01 1.384283172179996135e-01 1.429795694308914900e-01 1.495374713236463649e-01 1.555112632828610508e-01 1.604064684787332995e-01 1.643138607204098489e-01 1.687617222341111223e-01 1.735492932597975380e-01 1.767188162532889462e-01
1.767188162532889462e-01 1.809112240952628348e-01 1.892916489076752751e-01 1.958884711331261019e-01 2.009978109119539835e-01 2.052565622653562682e-01 2.082381947459571725e-01 2.093654015778230737e-01 2.079062999625042041e-01 2.030536197170958457e-01 1.942017172352003551e-01 1.815444235965593123e-01 1.644568305709077916e-01 1.526563091344455558e-01 1.445438699851283593e-01 1.436648489104518644e-01 1.458847215428320243e-01 1.504267235475836295e-01 1.544444354378377571e-01 1.575898054413349958e-01 1.601019703888791612e-01 1.644125114583036285e-01 1.670927640219466437e-01 1.718660405749540820e-01 1.767188162532889462e-01
1.767188162532889462e-01 1.829293442670584524e-01 1.935399327905488465e-01 2.013978357555633314e-01 2.090313796678515967e-01 2.162162293171485394e-01 2.225227173381891521e-01 2.272954597093790607e-01 2.295848989877067037e-01 2.281356026754721156e-01 2.197658811219331820e-01 2.080312230238794413e-01 1.966144922609451007e-01 1.905469419517633323e-01 1.892877991323028697e-01 1.848744142907386423e-01 1.789342598183106259e-01 1.728866200842576750e-01 1.675915395383522355e-01 1.652767271061905408e-01 1.639112326310635248e-01 1.638798041454266052e-01 1.671054749764855629e-01 1.706022342291114158e-01 1.767188162532889462e-01
1.767188162532889462e-01 1.842111630852528437e-01 1.957736234738168268e-01 2.050584584816288469e-01 2.144950973252198745e-01 2.238676511742143382e-01 2.327893156170410260e-01 2.405976555712843468e-01 2.462235908123470429e-01 2.462499615304551970e-01 2.429206929247369473e-01 2.404456982702715684e-01 2.589108022713400015e-01 3.114374502200942252e-01 3.549298408542343464e-01 3.333089861377048768e-01 2.633756574907469283e-01 2.139094456537302125e-01 1.881684467153135476e-01 1.745998490314749907e-01 1.679000424961207549e-01 1.657860020656156952e-01 1.669365226644247413e-01 1.698198326887569720e-01 1.767188162532889462e-01
1.767188162532889462e-01 1.846507326065462695e-01 1.965322865188068868e-01 2.063440716956801424e-01 2.164385109176066857e-01 2.266292386930160996e-01 2.365568160046193635e-01 2.455705002996873831e-01 2.525704075853162922e-01 2.520552674646220348e-01 2.531302467762536201e-01 2.619544720036933172e-01 3.225989584882366645e-01 6.186270245929874623e-01 6.628003336073476914e-01 6.743913556326291969e-01 3.641333665349077431e-01 2.417877995069447894e-01 1.996645392616646641e-01 1.796959548638073501e-01 1.700648551624569793e-01 1.664197842318488607e-01 1.667395377521396771e-01 1.695550673570882516e-01 1.767188162532889462e-01
1.767188162532889462e-01 1.842111630851945014e-01 1.957736234747570192e-01 2.050584584818826717e-01 2.144950973252361670e-01 2.238676511737375807e-01 2.327893156171402245e-01 2.405976555711803189e-01 2.462235908124252581e-01 2.462499615296213085e-01 2.429206929255723069e-01 2.404456982690224287e-01 2.589108022797915187e-01 3.114374502153318680e-01 3.549298408561244456e-01 3.333089861411370758e-01 2.633756574908212023e-01 2.139094456554495871e-01 1.881684467152639484e-01 1.745998490302716477e-01 1.679000424978537298e-01 1.657860020664905509e-01 1.669365226641635336e-01 1.698198326888138432e-01 1.767188162532889462e-01
1.767188162532889462e-01 1.829293442670648639e-01 1.935399327901894673e-01 2.013978357558056653e-01 2.090313796679945102e-01 2.162162293180851791e-01 2.225227173378894197e-01 2.272954597099843543e-01 2.295848989873410795e-01 2.281356026761603706e-01 2.197658811230145670e-01 2.080312230237107152e-01 1.966144922596644862e-01 1.905469419490091743e-01 1.892877991326642750e-01 1.848744142858236017e-01 1.789342598195338419e-01 1.728866200836214617e-01 1.675915395378435035e-01 1.652767271061744148e-01 1.639112326285186161e-01 1.638798041448429887e-01 1.671054749758633939e-01 1.706022342286012961e-01 1.767188162532889462e-01
1.767188162532889462e-01 1.809112240946835204e-01 1.892916489081716835e-01 1.958884711345369456e-01 2.009978109137477154e-01 2.052565622649256682e-01 2.082381947457789539e-01 2.093654015776250932e-01 2.079062999621945074e-01 2.030536197167858714e-01 1.942017172351490628e-01 1.815444235967064168e-01 1.644568305709214751e-01 1.526563091346945233e-01 1.445438699864507459e-01 1.436648489118192151e-01 1.458847215424617649e-01 1.504267235477225739e-01 1.544444354376899586e-01 1.575898054402147253e-01 1.601019703888368895e-01 1.644125114570690327e-01 1.670927640212989396e-01 1.718660405756301246e-01 1.767188162532889462e-01
1.767188162532889462e-01 1.792331402055042933e-01 1.839237581447751291e-01 1.889926601971971820e-01 1.915907421860039983e-01 1.928476651417756482e-01 1.926427088030329138e-01 1.905373926358973902e-01 1.861324763383235548e-01 1.800620226755849373e-01 1.700627119086648986e-01 1.575085224634383274e-01 1.464417306055484924e-01 1.383910626080378237e-01 1.331701842659509250e-01 1.334917827900949927e-01 1.384283172179315846e-01 1.429795694309878851e-01 1.495374713240543441e-01 1.555112632828553332e-01 1.604064684789925366e-01 1.643138607209065905e-01 1.687617222339929390e-01 1.735492932610564476e-01 1.767188162532889462e-01
1.767188162532889462e-01 1.777794572983385779e-01 1.780645653119495020e-01 1.798894300980259653e-01 1.811274495061084566e-01 1.805839611986457260e-01 1.778465790834800608e-01 1.734406075149222126e-01 1.671545672872557231e-01 1.602517937713728857e-01 1.530569366824415523e-01 1.445842573848029056e-01 1.365417991197533099e-01 1.309079474173383828e-01 1.325029119241507292e-01 1.371319824517917840e-01 1.415098064979347925e-01 1.464814176743500507e-01 1.536582169799828035e-01 1.598128619315419829e-01 1.649301718062764488e-01 1.690515043638635972e-01 1.723975980483484771e-01 1.749254079773601700e-01 1.767188162532889462e-01
1.767188162532889462e-01 1.763075906029146489e-01 1.750509461500975861e-01 1.728807612049789444e-01 1.696873343097820286e-01 1.670461286413820468e-01 1.640786129235417556e-01 1.595252717959796951e-01 1.526834436643053905e-01 1.449839416509860757e-01 1.385407240514596738e-01 1.355418948501005694e-01 1.343579119573588276e-01 1.355418948495123455e-01 1.385407240521545902e-01 1.449839416513061530e-01 1.526834436642679760e-01 1.595252717960049527e-01 1.640786129233065549e-01 1.670461286408735646e-01 1.696873343098227183e-01 1.728807612053733511e-01 1.750509461496608521e-01 1.763075906031395246e-01 1.767188162532889462e-01
1.767188162532889462e-01 1.749254079779648530e-01 1.723975980474633518e-01 1.690515043657479510e-01 1.649301718082371859e-01 1.598128619315833387e-01 1.536582169805569831e-01 1.464814176742732510e-01 1.415098064978036752e-01 1.371319824519968977e-01 1.325029119242564501e-01 1.309079474161145840e-01 1.365417991187374558e-01 1.445842573852404167e-01 1.530569366828808675e-01 1.602517937717405916e-01 1.671545672871709298e-01 1.734406075148773596e-01 1.778465790838311689e-01 1.805839611986185533e-01 1.811274495062530909e-01 1.798894300988422568e-01 1.780645653120395688e-01 1.777794572984395527e-01 1.767188162532889462e-01
1.767188162532889462e-01 1.735492932590509685e-01 1.687617222335998368e-01 1.643138607187274447e-01 1.604064684795389328e-01 1.555112632835318753e-01 1.495374713237783426e-01 1.429795694310160847e-01 1.384283172189469668e-01 1.334917827912547594e-01 1.331701842669887059e-01 1.383910626074824901e-01 1.464417306052325507e-01 1.575085224633760439e-01 1.700627119077163241e-01 1.800620226756476094e-01 1.861324763385238668e-01 1.905373926361946801e-01 1.926427088031290313e-01 1.928476651414517962e-01 1.915907421867346916e-01 1.889926601985227883e-01 1.839237581455376580e-01 1.792331402052252387e-01 1.767188162532889462e-01
1.767188162532889462e-01 1.718660405754157405e-01 1.670927640215777721e-01 1.644125114582463687e-01 1.601019703888112156e-01 1.575898054412923910e-01 1.544444354373730177e-01 1.504267235470932718e-01 1.458847215432686750e-01 1.436648489122420436e-01 1.445438699853526243e-01 1.526563091344294854e-01 1.644568305709323830e-01 1.815444235966991449e-01 1.942017172349492504e-01 2.030536197169219015e-01 2.079062999623989272e-01 2.093654015775969490e-01 2.082381947461811600e-01 2.052565622648617194e-01 2.009978109135009405e-01 1.958884711343437113e-01 1.892916489067610619e-01 1.809112240941702643e-01 1.767188162532889462e-01
1.767188162532889462e-01 1.706022342309296280e-01 1.671054749767986736e-01 1.638798041454705146e-01 1.639112326308406198e-01 1.652767271061504617e-01 1.675915395381308015e-01 1.728866200837096689e-01 1.789342598192738554e-01 1.848744142851592720e-01 1.892877991351508415e-01 1.905469419531490294e-01 1.966144922587341193e-01 2.080312230231508019e-01 2.197658811221708253e-01 2.281356026761859335e-01 2.295848989868545520e-01 2.272954597091425555e-01 2.225227173383521884e-01 2.162162293176400074e-01 2.090313796674131974e-01 2.013978357552629328e-01 1.935399327895839516e-01 1.829293442670850145e-01 1.767188162532889462e-01
1.767188162532889462e-01 1.698198326883940679e-01 1.669365226637321009e-01 1.657860020675296642e-01 1.679000424970986394e-01 1.745998490304014883e-01 1.881684467118014126e-01 2.139094456546764556e-01 2.633756574887460289e-01 3.333089861388472963e-01 3.549298408545967787e-01 3.114374502148603563e-01 2.589108022738952353e-01 2.404456982697323886e-01 2.429206929258829473e-01 2.462499615295902777e-01 2.462235908127121675e-01 2.405976555714828546e-01 2.327893156172655131e-01 2.238676511740352038e-01 2.144950973241669112e-01 2.050584584832779445e-01 1.957736234742550596e-01 1.842111630855475524e-01 1.767188162532889462e-01
1.767188162532889462e-01 1.695550673570973277e-01 1.667395377486629859e-01 1.664197842320790655e-01 1.700648551641627260e-01 1.796959548635643222e-01 1.996645392609444902e-01 2.417877995064744157e-01 3.641333665349076321e-01 6.743913556341321058e-01 6.628003336073478025e-01 6.186270245930713951e-01 3.225989584882366645e-01 2.619544720035230645e-01 2.531302467766012310e-01 2.520552674645578084e-01 2.525704075854224295e-01 2.455705002999516162e-01 2.365568160046999657e-01 2.266292386932337588e-01 2.164385109169100208e-01 2.063440716956467524e-01 1.965322865188068868e-01 1.846507326065462695e-01 1.767188162532889462e-01
